S.......
.###.##.
...#....
##.#.##.
...#....
.#.###..
.#.....#
.#####.G
