S.......
.###....
...#....
...#..G.
........
........
........
........
